1111111111111111
1110100000000C11
1C1C1N0000011P01
1E00000000000001
1111111111111111