11111111111
1C000E00001
10000000001
10000000001
100000P0001
10000000001
11111111111
1000C000001
100C0000001
10C000000C1
11111111111