11111111111
1C000E00001
10000000001
10000000001
100000P0001
10000000001
11110001111
1000C000001
100C0010001
10C000000C1
11111111111