11111111111111111111111111111111111111111111111
1P000000000000000000000000000000000000000000001
1C000000000000000000000000000000000000000000001
10000000000000000000000000000000000000000000001
1E000000000000000000000000000000000000000000001
11111111111111111111111111111111111111111111111