1111111
1001001
1P00C01
1E00001
1111111