11111111111
1P0000E0001
10000000001
1000000P001
10000000001
100E00000E1
10000000001
10000000001
10000000001
100P00000P1
11111111111